40
19
048 049 049 049 049 049 049 049 049 049 049 049 049 049 049 049 049 049 049 049 049 049 049 049 049 049 049 049 049 049 049 049 049 049 049 049 049 049 049 050
064 065 081 081 081 081 081 081 081 081 081 081 081 081 081 081 081 081 081 081 081 081 081 081 081 081 081 081 081 081 081 081 081 081 081 081 081 081 065 066
064 066 096 096 096 096 096 096 096 096 096 096 096 096 096 096 006 006 096 096 096 096 096 096 096 096 096 096 096 096 096 096 096 096 096 096 096 096 064 066
064 066 096 096 096 096 096 096 096 096 096 096 096 096 096 096 006 006 096 096 096 096 096 096 096 096 096 096 096 096 096 096 096 096 096 096 096 096 064 066
064 066 000 000 000 000 000 000 000 000 000 000 000 000 000 000 000 000 000 000 000 000 000 000 000 000 000 000 000 000 000 000 000 000 000 000 000 000 064 066
064 066 000 000 000 000 000 000 000 000 000 000 000 000 000 000 000 000 000 000 000 000 000 000 000 000 000 000 000 000 000 000 000 000 000 000 000 000 064 066
064 066 000 000 000 000 000 000 000 000 000 000 000 000 000 000 000 000 000 000 000 000 000 000 000 000 000 000 000 000 000 000 000 000 000 000 000 000 064 066
064 066 000 000 000 000 000 000 000 000 000 000 000 000 000 000 000 000 000 000 000 000 000 000 000 000 000 000 000 000 000 000 000 000 000 000 000 000 064 066
064 066 000 000 000 000 000 000 000 000 000 000 000 000 000 000 000 000 000 000 000 000 000 000 000 000 000 000 000 000 000 000 000 000 000 000 000 000 064 066
064 066 000 000 000 000 000 000 000 000 000 000 000 000 000 000 000 000 000 000 000 000 000 000 000 000 000 000 000 000 000 000 000 000 000 000 000 000 064 066
064 066 000 000 000 000 000 000 000 000 000 000 000 000 007 000 000 000 000 000 000 000 000 000 000 000 000 000 000 000 000 000 000 000 000 000 000 000 064 066
064 066 000 000 000 000 000 000 000 000 000 000 000 000 000 000 000 000 000 000 000 000 000 000 000 000 000 000 000 000 000 000 000 000 000 000 000 000 064 066
064 066 000 000 000 000 000 000 000 000 000 000 000 000 000 000 000 000 000 000 000 000 000 000 000 000 000 000 000 000 000 000 000 000 000 000 000 000 064 066
064 066 000 000 000 000 000 000 000 000 000 000 000 000 000 000 000 000 000 000 000 000 000 000 000 000 000 000 000 000 000 000 000 000 000 000 000 000 064 066
064 066 000 000 000 000 000 000 000 000 000 000 000 000 000 000 000 000 000 000 000 000 000 000 000 000 000 000 000 000 000 000 000 000 000 000 000 000 064 066
064 065 049 049 049 049 049 049 049 049 049 049 049 049 049 050 006 006 048 049 049 049 049 049 049 049 049 049 049 049 049 049 049 049 049 049 049 049 065 066
080 081 081 081 081 081 081 081 081 081 081 081 081 081 081 082 006 006 080 081 081 081 081 081 081 081 081 081 081 081 081 081 081 081 081 081 081 081 081 082
096 096 096 096 096 096 096 096 096 096 096 096 096 096 096 096 006 006 096 096 096 096 096 096 096 096 096 096 096 096 096 096 096 096 096 096 096 096 096 096
096 096 096 096 096 096 096 096 096 096 096 096 096 096 096 096 006 006 096 096 096 096 096 096 096 096 096 096 096 096 096 096 096 096 096 096 096 096 096 096


6
1 2 1 16

38 2 1 16

2 1 14 3
18 1 20 3

2 15 14 4
18 15 20 4


2
16 2 2 1 map_000.txt 16 16
16 19 2 1 map_002.txt 16 0

0
1 100 200 17 41 30 23 .01
3 200 100 17 41 30 23 1
4 300 100 17 41 30 23 .01
5 400 100 17 41 30 23 .01
1 500 100 17 41 30 23 .01