10
10
1 4 4 4 4 4 4 4 4 1 
2 0 7 7 7 7 7 7 0 3 
2 7 0 7 7 7 7 0 7 3 
2 7 7 0 7 7 0 7 7 3 
6 7 7 7 1 1 7 7 7 3 
6 7 7 7 1 1 7 7 7 3 
2 7 7 0 7 7 0 7 7 3 
2 7 0 7 7 7 7 0 7 3 
2 0 7 7 7 7 7 7 0 3 
1 5 5 5 5 5 5 5 5 1

6
0 1 1 3
0 6 1 3
9 1 1 8
1 0 8 1
1 9 8 1
4 4 2 2

1
0 4 1 2 map_004.txt 28 1

1
0 200 100 17 41 30 23 100