40
19
048 049 049 049 049 049 049 049 049 049 049 049 049 049 049 049 049 049 049 049 049 049 049 049 049 049 049 049 049 049 049 049 049 049 049 049 049 049 049 050
064 065 081 081 081 081 081 081 081 081 081 081 081 081 081 081 081 081 081 081 081 081 081 081 081 081 081 081 081 081 081 081 081 081 081 081 081 081 065 066
064 066 096 096 096 096 096 096 096 096 096 096 096 096 096 096 096 096 096 096 096 096 096 096 096 096 096 096 096 096 096 096 096 096 096 096 096 096 064 066
064 066 096 096 096 096 096 096 096 096 096 096 096 096 096 096 096 096 096 096 096 096 096 096 096 096 096 096 096 096 096 096 096 096 096 096 096 096 064 066
064 066 000 000 000 000 000 000 000 000 000 000 000 000 000 000 000 000 000 000 000 000 000 000 000 000 000 000 000 000 000 000 000 000 000 000 000 000 064 066
064 066 000 000 000 000 000 000 000 000 000 000 000 000 000 000 000 000 000 000 000 000 000 000 000 000 000 000 000 000 000 000 000 000 000 000 000 000 064 066
064 066 000 000 000 000 000 000 000 000 000 000 000 000 000 000 000 000 000 000 000 000 000 000 000 000 000 000 000 000 000 000 000 000 000 000 000 000 064 066
064 066 000 000 000 000 000 000 000 000 000 000 000 000 000 000 000 000 000 000 000 000 000 000 000 000 000 000 000 000 000 000 000 000 000 000 000 000 064 066
064 066 000 000 000 000 000 000 000 000 000 000 000 000 000 000 000 000 000 000 000 000 000 000 000 000 000 000 000 000 000 000 000 000 000 000 000 000 064 066
064 066 000 000 000 000 000 000 000 000 000 000 000 000 000 000 000 000 000 000 000 000 000 000 000 000 000 000 000 000 000 000 000 000 000 000 000 000 064 066
064 066 000 000 000 000 000 000 000 000 000 000 000 000 007 000 000 000 000 000 000 000 000 000 000 000 000 000 000 000 000 000 000 000 000 000 000 000 064 066
064 066 000 000 000 000 000 000 000 000 000 000 000 000 000 000 000 000 000 000 000 000 000 000 000 000 000 000 000 000 000 000 000 000 000 000 000 000 064 066
064 066 000 000 000 000 000 000 000 000 000 000 000 000 000 000 000 000 000 000 000 000 000 000 000 000 000 000 000 000 000 000 000 000 000 000 000 000 064 066
064 066 000 000 000 000 000 000 000 000 000 000 000 000 000 000 000 000 000 000 000 000 000 000 000 000 000 000 000 000 000 000 000 000 000 000 114 000 064 066
064 066 000 000 000 000 000 000 000 000 000 000 000 000 000 000 000 000 000 000 000 000 000 000 000 000 000 000 000 000 000 000 113 000 000 000 130 000 064 066
064 065 049 049 049 049 049 049 049 049 049 049 049 049 049 050 006 006 048 049 049 049 049 049 049 049 049 049 049 049 049 049 050 006 006 048 049 049 065 066
080 081 081 081 081 081 081 081 081 081 081 081 081 081 081 082 006 006 080 081 081 081 081 081 081 081 081 081 081 081 081 081 082 006 006 080 081 081 081 082
096 096 096 096 096 096 096 096 096 096 096 096 096 096 096 096 006 006 096 096 096 096 096 096 096 096 096 096 096 096 096 096 096 096 096 096 096 096 096 096
096 096 096 096 096 096 096 096 096 096 096 096 096 096 096 096 006 006 096 096 096 096 096 096 096 096 096 096 096 096 096 096 096 096 096 096 096 096 096 096


7
1 2 1 16

1 1 40 3
18 1 20 3

38 2 1 16

1 15 15 4
18 15 15 4
35 15 5 4

3
16 2 2 1 map_000.txt 16 16
33 17 2 1 map_002.txt 16 0
16 18 2 1 outdoor2.txt 19 13

3
1 700 100 17 41 30 23 .4
1 800 100 17 41 30 23 .4
1 900 100 17 41 30 23 .4
5 400 100 17 41 30 23 .4
1 500 100 17 41 30 23 .4