40
19
051 054 054 054 054 054 054 054 054 054 054 054 054 054 054 054 054 054 054 054 054 054 054 054 054 054 054 054 054 054 054 054 054 054 054 054 054 054 054 053
070 116 116 116 116 116 116 116 116 116 116 116 116 116 116 116 116 116 116 116 116 116 116 116 116 116 116 116 116 116 116 116 116 116 116 116 116 116 116 070
070 116 116 116 116 116 116 116 116 116 116 116 116 116 116 116 116 116 116 116 116 116 116 116 116 116 116 116 116 116 116 116 116 116 116 116 116 116 116 070
070 087 087 087 087 087 087 087 087 087 087 087 087 087 087 087 087 117 087 087 087 087 087 087 087 087 087 087 087 087 087 087 087 087 087 087 087 087 087 070
070 087 028 028 028 028 028 028 028 028 044 044 044 044 044 044 012 012 012 012 012 006 006 006 006 006 030 030 030 030 030 087 087 087 087 087 087 087 087 070
070 087 028 028 028 028 028 028 028 028 044 044 044 044 044 044 012 012 012 012 012 006 006 006 006 006 030 030 030 030 030 087 087 087 087 087 087 087 087 070
070 087 016 016 016 016 087 087 087 087 087 087 087 087 087 087 087 087 087 087 087 087 087 087 087 087 087 087 087 087 087 087 087 087 023 087 087 087 087 070
070 087 016 016 016 016 087 087 087 087 087 087 087 087 087 087 087 087 087 087 087 087 087 087 087 087 087 087 087 087 087 087 087 087 087 087 087 087 087 070
070 087 087 087 087 087 087 087 087 087 087 087 087 087 087 087 023 087 087 087 087 087 087 087 087 087 087 023 087 087 087 087 087 087 087 087 087 087 087 070
070 087 087 087 087 087 087 087 087 087 087 087 023 087 087 008 030 024 087 087 087 087 087 087 087 087 087 087 087 087 087 087 087 087 087 087 087 087 087 070
070 087 087 087 087 087 087 087 087 087 087 087 087 087 023 030 030 030 007 087 087 087 087 087 087 087 087 087 087 087 023 087 087 087 087 087 087 087 087 070
070 087 087 087 087 087 087 087 087 087 087 087 087 024 030 030 030 030 030 008 087 087 087 087 087 087 087 087 087 087 087 087 087 087 087 087 087 087 087 070
070 087 087 087 087 087 087 087 087 087 087 087 087 087 007 030 030 030 024 087 087 087 087 087 087 087 087 087 087 087 087 087 087 087 087 087 087 087 087 070
070 087 087 087 087 087 087 087 087 087 087 087 087 087 087 008 030 023 087 087 087 087 087 087 087 087 087 087 087 087 087 087 087 023 087 087 087 087 087 070
070 087 087 087 087 087 087 087 087 087 087 087 087 087 087 087 024 087 087 087 087 087 087 087 087 087 087 087 087 087 087 087 087 087 087 087 087 087 087 070
070 087 087 087 087 087 087 087 087 087 087 087 087 087 087 087 006 006 087 087 087 087 087 087 087 087 087 087 087 087 087 087 087 087 087 087 087 087 087 070
083 054 054 054 054 054 054 054 054 054 054 054 054 054 054 054 006 006 054 054 054 054 054 054 054 054 054 054 054 054 054 054 054 054 054 054 054 054 054 085
116 116 116 116 116 116 116 116 116 116 116 116 116 116 116 116 006 006 116 116 116 116 116 116 116 116 116 116 116 116 116 116 116 116 116 116 116 116 116 116
116 116 116 116 116 116 116 116 116 116 116 116 116 116 116 116 006 006 116 116 116 116 116 116 116 116 116 116 116 116 116 116 116 116 116 116 116 116 116 116

5
0 2 1 16

39 2 1 16

2 2 36 1

2 16 14 4
18 16 20 4


1
16 19 2 1 outdoor.txt 14.5 8

0
1 116 200 17 011 30 23 .01
3 200 116 17 011 30 23 1
4 300 116 17 011 30 23 .01
5 400 116 17 011 30 23 .01
1 500 116 17 011 30 23 .01